Function of Sartorius	flexes, weakly abducts, rotates upper leg; flexes and medially rotates lower leg
Muscle w/ function flexes, weakly abducts, rotates upper leg; flexes and medially rotates lower leg	Sartorius
Origin of Sartorius	Just below tip of ASIS
Muscle with origin 'Just below tip of ASIS'	Sartorius
Insertion of Sartorius	Pes anserinus, on tibia
Muscle with insertion 'Pes anserinus, on tibia'	Sartorius
Sartorius overlaps...	Gracilis, Rectus Femoris, Vastus Medialis, Adductor Longus
Gracilis, Rectus Femoris, Vastus Medialis, Adductor Longus are overlapped by...	Sartorius
Function of Deltoid	flex arm forward, abducts outward, pulls backward
Muscle w/ function flex arm forward, abducts outward, pulls backward	Deltoid
Origin of Deltoid	lateral 1/3 of clavicle, acromion process, spine of scapula
Muscle with origin 'lateral 1/3 of clavicle, acromion process, spine of scapula'	Deltoid
Insertion of Deltoid	Deltoid tuberosity halfway down humerus
Muscle with insertion 'Deltoid tuberosity halfway down humerus'	Deltoid
Deltoid overlaps...	Biceps brachii, tendon of pectoralis, infraspinatus, supraspinatus, teres major/minor, upper triceps
Biceps brachii, tendon of pectoralis, infraspinatus, supraspinatus, teres major/minor, upper triceps are overlapped by...	Deltoid
Function of Multifidus	extend, laterally flex, rotate vertebral column
Muscle w/ function extend, laterally flex, rotate vertebral column	Multifidus
Origin of Multifidus	Sacrum, PSIS, spinous processes of vertebrae
Muscle with origin 'Sacrum, PSIS, spinous processes of vertebrae'	Multifidus
Insertion of Multifidus	Spinous processes of all vertebrae but the atlas
Muscle with insertion 'Spinous processes of all vertebrae but the atlas'	Multifidus
Multifidus is overlapped by...	Gluteus maximus, Erector spinae, trapezius
Gluteus maximus, Erector spinae, trapezius overlap...	Multifidus
Function of Scalenus Medius	Bends neck laterally; lifts first rib during forced inspiration
Muscle w/ function Bends neck laterally; lifts first rib during forced inspiration	Scalenus Medius
Origin of Scalenus Medius	Transferse processes from C2-C7 (occasionally C1)
Muscle with origin 'Transferse processes from C2-C7 (occasionally C1)'	Scalenus Medius
Insertion of Scalenus Medius	Medial part of top of first rib
Muscle with insertion 'Medial part of top of first rib'	Scalenus Medius
Scalenus Medius is overlapped by...	Sternocleidomastoid, Omohyoid, Trapezius
Sternocleidomastoid, Omohyoid, Trapezius overlap...	Scalenus Medius
